1111111111111111111111111111111111111
10000P00000000000C0000000000000000001
1111111111000000000000000000000000001
100000000E000000000000000000000000001
1111111111111111111111111111111111111