111111111111111
100000P00000001
10C000000000001
10000000000C001
10000E000000001
111111111111111